-------------------------
-------------------------
-     -----------       -
-       -------         -
-        -----          -
-         --            -
-                       -
-                       -
-@                      -
-                    ----
-                    ----
------               ----
------               ----
------        G      ----
------       ----    ----
------       ----    ----
------       ---- T  ----
-------------------------
-------------------------