-------------------------
-------------------------
-                       -
-                       -
-     m                 -
-             T         -
-             ---       -
-----                   -
----                    -
--                 m    -
-                       -
-   T                   -
-   ---             T   -
-                   -----
-@G                     -
-              -        -
-              -        -
-------------------------
-------------------------