-------------------------
-------------------------
-                       -
-                       -
-                       -
-                       -
-                       -
-----                   -
----                    -
--                      -
-                       -
-                       -
-                    ----
-                       -
-@G                     -
-                       -
-                       -
-------------------------
-------------------------