-------------------------
-------------------------
-                       -
-@                      -
-                       -
-                       -
-------         G       -
-------                 -
-------            ------
-------            ------
-                  ------
-                  ------
-                  ------
-                       -
-                       -
-                       -
-                       -
-------------------------
-------------------------