-------------------------
-------------------------
-                       -
-@G                     -
-                       -
-                       -
-------                 -
------          m       -
----               ------
--      M          ------
-                  ------
-      T           ------
-      ---         ------
-      ---             --
-      ---             --
-      ---             --
-      ---      T      --
-------------------------
-------------------------