-------------------------
-------------------------
-     -----------       -
-       -------         -
-        -----          -
-         --            -
-                       -
-                       -
-                       -
-                    ----
-                    ----
------               ----
------               ----
------               ----
------       ----    ----
------       ----    ----
------       ----    ----
-------------------------
-------------------------